11111111111111111
100100000001100E1
10000000000000001
10000000P00C00001
100000C0000100001
1C000010000000C01
11111111111111111