1111111111111111111111111111111
1001000000011000000000000000001
1000000000000000E00000000000001
10000000P00C0000000000000000001
10000CS000010000000000000000001
1C000110000000C0000000000000001
1111111111111111111111111111111